0000000000000000000000000000000000000000000000000000000000000000000000000000000000
0000000000000000000000000000000000000000000000000000000000000000000000000000000000
0000000000000000000000000000000000000000001111111111111111111111110000001100001100
0000000000000000000000000000000000001100000000000000000000000000000000000000000000
0000000000000000000000000000001110000000000000000000000000000000000001100000000000
0000000000000000000111111110000000000000100000000000001111000000000000000000000000
0000000000000000000000000000000000000000100000000000000000000000000000000000000000
0000000000000111100000000000000001110001100000000000000000000000000001111000000000
0000000000000000000000000000000000000001100000011110000000000010000000000000111000
0000000000000000000000000100000000000011100000000000000110000110000001000000000000
0000000000000000000100000100000000000011100000000000000000001110000001000000000000
0000000000000000000000000000000000000000000000000000000000000000000000000000000000
1111111111111111111111111111111111111111111111111111111111111111111001111111111111
0000000000000000000000000000000000000000000000000000000000000000000000000000000000
0000000000000000000000000000000000000000000000000000000000000000000000000000000000
0000000000000000000000000000000000000000000000000000000000000000000000000000000000
0000000000000000000000000000000000000000000000000000000000000000000000000000000000