100000000000000000000000000000000000000000000000000000000000000000000
000000000000000000000000000000000000000000000000000000000000000000000
000000000000000000000000000000003000000000111111111111111111111111000
000000000000000000000000000000000000110000000000000000000000000000000
000000000000000000000000000000111000000000000000000000000200000000000
000000000000000000011111111000000000000010000000000000111100000000000
000000000000000000000000000000000000000010000000000000000000000000000
000000000200011110000000000000000111000110000000002000000000003000000
000000000000000000000000000000000000000110000001111000000000001000000
000000000000000000000000010000000000001110000000000000011000011000000
000000000000000000010002010000000003001110000000000000000000111000000
111111111111111111111111111111111111111111111111111111111111111111111