1111111111111111
1001000100000000
1011010100000103
1000000010011111
1011110010010001
1010010010010101
1010011111000101
1010000000000101
1010100001000101
1011011110111101
1111111111111111